R 1080 640
NO ./resources/textures/0-bluestone.xpm
SO ./resources/textures/1-colorstone.xpm
EA ./resources/textures/2-eagle.xpm
WE ./resources/textures/3-redbrick.xpm
S  ./resources/textures/4-barrel.xpm
C 00,153,15
F 255,255,255

        1111111111111111111111111
        1000000001110000000000001
        1110000011100000020020001
        1001000000000000000000001
111111111011000001110000000000001
100000000011000001110111100001111
111101111111110111000000010000111
11110111111111011101010010000111
1100000011010101110000001000011
1000000020000E001100000010000111
1000022220000000001101000011000111
11000001110101011111011110000011
11110111011101010101111010000111
11111111111111111111111110011111
111111111111111111111111111111111
